"No","지역명","자치단체코드","자치단체명","행사축제명","2013","2012","2011","2010","2009","2013","2012","2011","2010","2009","2013","2012","2011","2010","2009"
"1","서울","1100000","서울본청","고궁을 무대로한 뮤지컬 공연","0","466139000","0","0","0","0","31759000","0","0","0","0","434380000","0","0","0"
"2","서울","1100000","서울본청","남산 봉수의식 등 전통문화 행사","711330100","728500000","0","0","0","0","0","0","0","0","711330100","728500000","0","0","0"
"3","서울","1100000","서울본청","사랑의 문화 나눔","0","596248000","0","0","0","0","0","0","0","0","0","596248000","0","0","0"
"4","서울","1100000","서울본청","서울 문화의 밤","585000000","0","0","0","0","0","0","0","0","0","585000000","0","0","0","0"
"5","서울","1100000","서울본청","서울빛초롱 축제(등 축제)","1111174280","1588019000","0","0","0","0","0","0","0","0","1111174280","1588019000","0","0","0"
"6","서울","1100000","서울본청","세계 한상대회","0","551102000","0","0","0","0","0","0","0","0","0","551102000","0","0","0"
"7","서울","1100000","서울본청","세계청소년야구선수권대회","0","1200000000","0","0","0","0","0","0","0","0","0","1200000000","0","0","0"
"8","서울","1100000","서울본청","아시아태평양 농아인 경기대회","0","999500000","0","0","0","0","350000000","0","0","0","0","649500000","0","0","0"
"9","서울","1100000","서울본청","연등회 연등 축제","700000000","500000000","0","0","0","0","0","0","0","0","700000000","500000000","0","0","0"
"10","서울","1100000","서울본청","왕궁수문장 교대의식 재현","2086759000","2094015000","0","0","0","0","0","0","0","0","2086759000","2094015000","0","0","0"
"11","서울","1100000","서울본청","우리동네 예술학교","809000000","0","0","0","0","0","0","0","0","0","809000000","0","0","0","0"
"12","서울","1100000","서울본청","전통무예 시범공연 및 체험행사 운영","1032250000","0","0","0","0","44000000","0","0","0","0","988250000","0","0","0","0"
"13","서울","1100000","서울본청","하이서울 페스티벌","1591343500","2703725000","0","0","0","0","0","0","0","0","1591343500","2703725000","0","0","0"
"14","서울","1115000","서울광진구","서울동화축제","360683000","0","0","0","0","199854000","0","0","0","0","160829000","0","0","0","0"
"15","서울","1119000","서울강북구","4.19혁명국민문화제","465000000","0","0","0","0","445000000","0","0","0","0","20000000","0","0","0","0"
"16","서울","1129000","서울영등포구","한강 여의도 봄꽃축제","417824000","427572000","0","0","0","0","20000000","0","0","0","417824000","407572000","0","0","0"
"17","서울","1133000","서울강남구","강남 패션페스티벌","498800000","0","0","0","0","0","0","0","0","0","498800000","0","0","0","0"
"18","서울","1133000","서울강남구","강남구민체육대회","366116330","351400000","0","0","0","0","0","0","0","0","366116330","351400000","0","0","0"
"19","서울","1133000","서울강남구","국제평화마라톤","412911330","397441000","0","0","0","0","0","0","0","0","412911330","397441000","0","0","0"
"20","서울","1134000","서울송파구","한성백제문화제","342689658","366308000","0","0","0","70800000","80000000","0","0","0","271889658","286308000","0","0","0"
"21","서울","1135000","서울강동구","강동선사문화축제","382375910","363509000","0","0","0","30000000","90000000","0","0","0","352375910","273509000","0","0","0"
"22","부산","2600000","부산본청","국제게임전시회 (지스타)","1474427000","1900000000","0","0","0","0","600000000","0","0","0","1474427000","1300000000","0","0","0"
"23","부산","2600000","부산본청","부산국제건축문화제","598708399","0","0","0","0","0","0","0","0","0","598708399","0","0","0","0"
"24","부산","2600000","부산본청","부산국제광고제","1663246046","1600000000","0","0","0","886488076","800000000","0","0","0","776757970","800000000","0","0","0"
"25","부산","2600000","부산본청","부산국제록페스티벌","500000000","0","0","0","0","0","0","0","0","0","500000000","0","0","0","0"
"26","부산","2600000","부산본청","부산국제수산무역 EXPO","0","555000000","0","0","0","0","80000000","0","0","0","0","475000000","0","0","0"
"27","부산","2600000","부산본청","부산국제신발피혁전시회","660000000","0","0","0","0","0","0","0","0","0","660000000","0","0","0","0"
"28","부산","2600000","부산본청","부산국제연극제","600000000","500000000","0","0","0","200000000","100000000","0","0","0","400000000","400000000","0","0","0"
"29","부산","2600000","부산본청","부산국제영화제","5741899000","7559075000","0","0","0","0","1500000000","0","0","0","5741899000","6059075000","0","0","0"
"30","부산","2600000","부산본청","부산바다축제","1200000000","1200000000","0","0","0","0","0","0","0","0","1200000000","1200000000","0","0","0"
"31","부산","2600000","부산본청","부산불꽃축제","1600000000","1600000000","0","0","0","600000000","600000000","0","0","0","1000000000","1000000000","0","0","0"
"32","부산","2600000","부산본청","부산비엔날레","1400000000","3030000000","0","0","0","700000000","1500000000","0","0","0","700000000","1530000000","0","0","0"
"33","부산","2600000","부산본청","부산콘텐츠마켓","1951819660","1859670000","0","0","0","1173126800","1199135000","0","0","0","778692860","660535000","0","0","0"
"34","부산","2600000","부산본청","세계여자매치레이스요트대회","548158960","568300000","0","0","0","0","0","0","0","0","548158960","568300000","0","0","0"
"35","부산","2611000","부산중구","부산자갈치축제","360000000","507853000","0","0","0","200000000","350000000","0","0","0","160000000","157853000","0","0","0"
"36","부산","2611000","부산중구","부산크리스마스트리트리축제","400000000","399898000","0","0","0","300000000","300000000","0","0","0","100000000","99898000","0","0","0"
"37","부산","2612000","부산서구","제8회 전국해양스포츠제전","1392404000","0","0","0","0","1297055000","0","0","0","0","95349000","0","0","0","0"
"38","부산","2616000","부산동래구","동래읍성역사축제","328700000","0","0","0","0","0","0","0","0","0","328700000","0","0","0","0"
"39","부산","2618000","부산북구","낙동강 1300리 구포나루 대축제","692386000","499927000","0","0","0","501007000","300000000","0","0","0","191379000","199927000","0","0","0"
"40","부산","2619000","부산해운대구","해운대모래축제","307000000","0","0","0","0","0","0","0","0","0","307000000","0","0","0","0"
"41","부산","2624000","부산수영구","제14회광안리어방축제","381028000","0","0","0","0","106000000","0","0","0","0","275028000","0","0","0","0"
"42","대구","2700000","대구본청","2013 대구세계에너지총회 개최 지원","838164712","0","0","0","0","0","0","0","0","0","838164712","0","0","0","0"
"43","대구","2700000","대구본청","2015 대구ㆍ경북 세계물포럼","973764890","0","0","0","0","0","0","0","0","0","973764890","0","0","0","0"
"44","대구","2700000","대구본청","대구국제마라톤대회","2100000000","1896427000","0","0","0","300000000","400000000","0","0","0","1800000000","1496427000","0","0","0"
"45","대구","2700000","대구본청","대구국제뮤지컬페스티벌","1811859010","1800000000","0","0","0","600000000","600000000","0","0","0","1211859010","1200000000","0","0","0"
"46","대구","2700000","대구본청","대구국제섬유박람회","779000000","779000000","0","0","0","0","0","0","0","0","779000000","779000000","0","0","0"
"47","대구","2700000","대구본청","대구국제안경전","0","475000000","0","0","0","0","0","0","0","0","0","475000000","0","0","0"
"48","대구","2700000","대구본청","대구국제오페라축제","862848269","900000000","0","0","0","175723991","0","0","0","0","687124278","900000000","0","0","0"
"49","대구","2700000","대구본청","대구국제육상경기대회","0","2239782000","0","0","0","0","600000000","0","0","0","0","1639782000","0","0","0"
"50","대구","2700000","대구본청","대구사진비엔날레","0","1600000000","0","0","0","0","800000000","0","0","0","0","800000000","0","0","0"
"51","대구","2700000","대구본청","대구예술발전소 문화행사","960000000","909266000","0","0","0","0","0","0","0","0","960000000","909266000","0","0","0"
"52","대구","2700000","대구본청","대구패션페어","700000000","700000000","0","0","0","350000000","350000000","0","0","0","350000000","350000000","0","0","0"
"53","대구","2700000","대구본청","시민회관 재개관기념공연 아시아오케스트라페스티벌","593945510","0","0","0","0","37007673","0","0","0","0","556937837","0","0","0","0"
"54","대구","2700000","대구본청","전국기능경기대회","0","3552821000","0","0","0","0","0","0","0","0","0","3552821000","0","0","0"
"55","대구","2700000","대구본청","컬러풀대구페스티벌","900000000","1392207000","0","0","0","300000000","556883000","0","0","0","600000000","835324000","0","0","0"
"56","대구","2700000","대구본청","형형색색달구벌관등놀이","599987400","278846000","0","0","0","299993700","0","0","0","0","299993700","278846000","0","0","0"
"57","대구","2771000","대구달성군","다큐뮤지컬 '귀신통 납시오'","399971000","0","0","0","0","50000000","0","0","0","0","349971000","0","0","0","0"
"58","대구","2771000","대구달성군","비슬산참꽃문화제","353964000","0","0","0","0","0","0","0","0","0","353964000","0","0","0","0"
"59","인천","2800000","인천본청","인천-청도국제요트대회","0","1087148000","0","0","0","0","1000000000","0","0","0","0","87148000","0","0","0"
"60","인천","2800000","인천본청","인천k-pop콘서트","0","484388000","0","0","0","0","0","0","0","0","0","484388000","0","0","0"
"61","인천","2800000","인천본청","인천세계장애대회","0","1152028000","0","0","0","0","0","0","0","0","0","1152028000","0","0","0"
"62","인천","2800000","인천본청","펜타포트 음악축제","1576000000","1387256000","0","0","0","76000000","42000000","0","0","0","1500000000","1345256000","0","0","0"
"63","인천","2815000","인천남동구","인천소래포구축제","380000000","346604000","0","0","0","0","0","0","0","0","380000000","346604000","0","0","0"
"64","인천","2816000","인천부평구","인천부평풍물대축제","302277370","307781000","0","0","0","0","0","0","0","0","302277370","307781000","0","0","0"
"65","인천","2818000","인천서구","대한민국자전거대축전","0","641959000","0","0","0","0","0","0","0","0","0","641959000","0","0","0"
"66","인천","2871000","인천강화군","강화군민의날체육대회","328460000","0","0","0","0","0","0","0","0","0","328460000","0","0","0","0"
"67","인천","2872000","인천옹진군","옹진군민의날 행사","0","483738000","0","0","0","0","0","0","0","0","0","483738000","0","0","0"
"68","인천","2872000","인천옹진군","옹진섬 나들이","0","1406473000","0","0","0","0","0","0","0","0","0","1406473000","0","0","0"
"69","광주","2900000","광주본청","2012 광주비엔날레","0","3000000000","0","0","0","0","1500000000","0","0","0","0","1500000000","0","0","0"
"70","광주","2900000","광주본청","2012 국제 light 비전엑스포","0","892800000","0","0","0","0","0","0","0","0","0","892800000","0","0","0"
"71","광주","2900000","광주본청","2013광주디자인비엔날레","1800000000","0","0","0","0","900000000","0","0","0","0","900000000","0","0","0","0"
"72","광주","2900000","광주본청","광주ACE Fair","1598026000","1599621000","0","0","0","798990000","799744000","0","0","0","799036000","799877000","0","0","0"
"73","광주","2900000","광주본청","광주세계김치문화축제","1573456000","1678066000","0","0","0","76000000","42000000","0","0","0","1497456000","1636066000","0","0","0"
"74","광주","2911000","광주동구","제11회 전국주민자치박람회","0","563204000","0","0","0","0","450000000","0","0","0","0","113204000","0","0","0"
"75","광주","2911000","광주동구","추억의7080 충장축제","1123997000","1187573000","0","0","0","0","1050000000","0","0","0","1123997000","137573000","0","0","0"
"76","대전","3000000","대전본청","2013 대한민국 산림박람회","989974530","0","0","0","0","494987270","0","0","0","0","494987260","0","0","0","0"
"77","대전","3000000","대전본청","대전국제푸드&와인페스티벌","2000000000","1100000000","0","0","0","0","0","0","0","0","2000000000","1100000000","0","0","0"
"78","대전","3000000","대전본청","대전사이언스페스티벌","715000000","0","0","0","0","0","0","0","0","0","715000000","0","0","0","0"
"79","대전","3000000","대전본청","제1회대한민국 평생학습박람회","0","973731000","0","0","0","0","492119000","0","0","0","0","481612000","0","0","0"
"80","대전","3000000","대전본청","제4회 대전뿌리문화축제","0","491000000","0","0","0","0","0","0","0","0","0","491000000","0","0","0"
"81","대전","3012000","대전중구","효문화 뿌리축제","536775760","0","0","0","0","0","0","0","0","0","536775760","0","0","0","0"
"82","대전","3013000","대전서구","제23회 서구민의 날 기념 『프리 폐스티벌』","0","376017000","0","0","0","0","20000000","0","0","0","0","356017000","0","0","0"
"83","대전","3014000","대전유성구","2012 대한민국 온천대축제","0","996013000","0","0","0","0","200000000","0","0","0","0","796013000","0","0","0"
"84","대전","3014000","대전유성구","2014 유성온천문화축제","629568780","0","0","0","0","0","0","0","0","0","629568780","0","0","0","0"
"85","울산","3100000","울산본청","간절곶해맞이","520000000","547069000","0","0","0","0","0","0","0","0","520000000","547069000","0","0","0"
"86","울산","3100000","울산본청","서머페스티벌","755000000","949868000","0","0","0","0","0","0","0","0","755000000","949868000","0","0","0"
"87","울산","3100000","울산본청","처용문화제","1071620000","1199722000","0","0","0","0","201617000","0","0","0","1071620000","998105000","0","0","0"
"88","울산","3111000","울산중구","울산마두희축제","430000000","0","0","0","0","150000000","0","0","0","0","280000000","0","0","0","0"
"89","울산","3112000","울산남구","울산고래축제","1981120000","1323896000","0","0","0","909271200","342000000","0","0","0","1071848800","981896000","0","0","0"
"90","울산","3113000","울산동구","울산조선해양축제","487000000","357000000","0","0","0","230000000","100000000","0","0","0","257000000","257000000","0","0","0"
"91","울산","3114000","울산북구","울산쇠부리축제","480000000","373000000","0","0","0","180000000","80000000","0","0","0","300000000","293000000","0","0","0"
"92","울산","3114000","울산북구","제12회 전국주민자치박람회","461958548","0","0","0","0","200000000","0","0","0","0","261958548","0","0","0","0"
"93","울산","3171000","울산울주군","옹기축제","700000000","708404000","0","0","0","350000000","350000000","0","0","0","350000000","358404000","0","0","0"
"94","울산","3171000","울산울주군","울산진하PWA세계윈드서핑대회","530000000","530000000","0","0","0","150000000","150000000","0","0","0","380000000","380000000","0","0","0"
"95","울산","3171000","울산울주군","울산진하세계여자비치발리볼대회","400000000","400000000","0","0","0","150000000","150000000","0","0","0","250000000","250000000","0","0","0"
"96","세종","3200000","세종본청","세종축제","686205400","0","0","0","0","0","0","0","0","0","686205400","0","0","0","0"
"97","경기","4100000","경기본청","2013 경기세계도자비엔날레","2193855000","0","0","0","0","0","0","0","0","0","2193855000","0","0","0","0"
"98","경기","4100000","경기본청","경기국제보트쇼","1938644000","4884486000","0","0","0","0","0","0","0","0","1938644000","4884486000","0","0","0"
"99","경기","4100000","경기본청","국내전시회 개최 지원","974995000","1249853000","0","0","0","389998000","519000000","0","0","0","584997000","730853000","0","0","0"
"100","경기","4100000","경기본청","굿게임쇼코리아","946771000","0","0","0","0","0","0","0","0","0","946771000","0","0","0","0"
"101","경기","4100000","경기본청","대한민국 뷰티디자인엑스포","1550000000","0","0","0","0","0","0","0","0","0","1550000000","0","0","0","0"
"102","경기","4100000","경기본청","민관군 한마음 위문공연","567500000","594000000","0","0","0","0","0","0","0","0","567500000","594000000","0","0","0"
"103","경기","4100000","경기본청","세계요트대회","0","2178000000","0","0","0","0","0","0","0","0","0","2178000000","0","0","0"
"104","경기","4100000","경기본청","전문전시회 개최 지원","795200000","1399999000","0","0","0","0","0","0","0","0","795200000","1399999000","0","0","0"
"105","경기","4111000","경기수원시","2012 대통령배 KeG 수원 정보과학축제","0","901320000","0","0","0","0","480000000","0","0","0","0","421320000","0","0","0"
"106","경기","4111000","경기수원시","경기도체육대회","569947610","0","0","0","0","0","0","0","0","0","569947610","0","0","0","0"
"107","경기","4111000","경기수원시","수원 세계 3쿠션 당구 월드컵","0","400000000","0","0","0","0","200000000","0","0","0","0","200000000","0","0","0"
"108","경기","4111000","경기수원시","수원 세계 다문화클럽 태권도한마당 대회","300000000","0","0","0","0","100000000","0","0","0","0","200000000","0","0","0","0"
"109","경기","4111000","경기수원시","수원국제음악제","0","477729000","0","0","0","0","33241000","0","0","0","0","444488000","0","0","0"
"110","경기","4111000","경기수원시","수원화성국제연극제","735175000","0","0","0","0","32000000","0","0","0","0","703175000","0","0","0","0"
"111","경기","4111000","경기수원시","수원화성문화제","1766175000","1592042000","0","0","0","225000000","63000000","0","0","0","1541175000","1529042000","0","0","0"
"112","경기","4111000","경기수원시","수원화성박물관 특별기획전","332662000","356000000","0","0","0","185458800","45600000","0","0","0","147203200","310400000","0","0","0"
"113","경기","4111000","경기수원시","정보과학축제","543574050","0","0","0","0","0","0","0","0","0","543574050","0","0","0","0"
"114","경기","4111000","경기수원시","제10회 한국스페셜 올림픽대회","400000000","0","0","0","0","150000000","0","0","0","0","250000000","0","0","0","0"
"115","경기","4111000","경기수원시","피스컵 수원 국제클럽 축구대회","0","480000000","0","0","0","0","0","0","0","0","0","480000000","0","0","0"
"116","경기","4111000","경기수원시","화성행궁 상설한마당","1058707000","1009688000","0","0","0","54868000","60000000","0","0","0","1003839000","949688000","0","0","0"
"117","경기","4112000","경기성남시","경기도 체육대회","349174380","355732000","0","0","0","0","0","0","0","0","349174380","355732000","0","0","0"
"118","경기","4112000","경기성남시","시민체육대회","557651970","596633000","0","0","0","0","0","0","0","0","557651970","596633000","0","0","0"
"119","경기","4112000","경기성남시","앱솔루트 클래식Ⅵ","356162287","353062000","0","0","0","0","0","0","0","0","356162287","353062000","0","0","0"
"120","경기","4112000","경기성남시","외국인 유학생 문화 대축전","430000000","350000000","0","0","0","350000000","350000000","0","0","0","80000000","0","0","0","0"
"121","경기","4112000","경기성남시","유명오케스트라 초청공연","0","217207000","0","0","0","0","0","0","0","0","0","217207000","0","0","0"
"122","경기","4120000","경기고양시","고양국제꽃박람회","1900000000","4000000000","0","0","0","900000000","2000000000","0","0","0","1000000000","2000000000","0","0","0"
"123","경기","4120000","경기고양시","국제전국 도 체육대회 개최","0","745044000","0","0","0","0","0","0","0","0","0","745044000","0","0","0"
"124","경기","4120000","경기고양시","시민축제개최","0","428640000","0","0","0","0","0","0","0","0","0","428640000","0","0","0"
"125","경기","4120000","경기고양시","장애인체전","0","492205000","0","0","0","0","229146000","0","0","0","0","263059000","0","0","0"
"126","경기","4120000","경기고양시","장애인학생-소년체전","0","684200000","0","0","0","0","214937000","0","0","0","0","469263000","0","0","0"
"127","경기","4120000","경기고양시","제6회 국제다큐영화제","800000000","0","0","0","0","700000000","0","0","0","0","100000000","0","0","0","0"
"128","경기","4129000","경기용인시","용인봄꽃축제","415478000","422310000","0","0","0","0","0","0","0","0","415478000","422310000","0","0","0"
"129","경기","4115000","경기부천시","경기도생활체육대축전","0","1130334000","0","0","0","0","100000000","0","0","0","0","1030334000","0","0","0"
"130","경기","4115000","경기부천시","복사골예술제","400000000","400000000","0","0","0","0","2300000","0","0","0","400000000","397700000","0","0","0"
"131","경기","4115000","경기부천시","부천국제만화축제","549310260","649494000","0","0","0","100000000","200000000","0","0","0","449310260","449494000","0","0","0"
"132","경기","4115000","경기부천시","부천국제학생애니메이션페스티벌","752794392","829108000","0","0","0","149993756","230000000","0","0","0","602800636","599108000","0","0","0"
"133","경기","4115000","경기부천시","제18회 부천국제판타스틱영화제","2198858422","2740261000","0","0","0","500000000","1000000000","0","0","0","1698858422","1740261000","0","0","0"
"134","경기","4119000","경기안산시","경기안산항공전","2200000000","2200000000","0","0","0","1600000000","1600000000","0","0","0","600000000","600000000","0","0","0"
"135","경기","4119000","경기안산시","단원미술제","332975000","0","0","0","0","0","0","0","0","0","332975000","0","0","0","0"
"136","경기","4119000","경기안산시","안산국제거리극","750000000","900000000","0","0","0","62827000","100000000","0","0","0","687173000","800000000","0","0","0"
"137","경기","4119000","경기안산시","안산희망마라톤대회","0","349927000","0","0","0","0","200000000","0","0","0","0","149927000","0","0","0"
"138","경기","4119000","경기안산시","제24회 경기도생활체육대축전 개최","1238075000","0","0","0","0","100000000","0","0","0","0","1138075000","0","0","0","0"
"139","경기","4114000","경기안양시","안양시민축제","480200000","484593000","0","0","0","0","0","0","0","0","480200000","484593000","0","0","0"
"140","경기","4123000","경기남양주시","2013 남양주 슬로푸드 국제대회","3720000000","0","0","0","0","2200000000","0","0","0","0","1520000000","0","0","0","0"
"141","경기","4123000","경기남양주시","남양주 다산문화제","626953000","800000000","0","0","0","0","0","0","0","0","626953000","800000000","0","0","0"
"142","경기","4134000","경기화성시","2013 동아시안컵 대회","309197130","0","0","0","0","0","0","0","0","0","309197130","0","0","0","0"
"143","경기","4134000","경기화성시","2013 코리아매치컵 세계요트대회&경기화성해양페스티벌","2477062422","0","0","0","0","1277000000","0","0","0","0","1200062422","0","0","0","0"
"144","경기","4134000","경기화성시","경기국제보트쇼","0","4351532000","0","0","0","0","2227397000","0","0","0","0","2124135000","0","0","0"
"145","경기","4134000","경기화성시","올림픽   축구   대표팀  평가전","0","300000000","0","0","0","0","100000000","0","0","0","0","200000000","0","0","0"
"146","경기","4134000","경기화성시","월드컵  축구  대표팀   평가전","0","489845000","0","0","0","0","149900000","0","0","0","0","339945000","0","0","0"
"147","경기","4134000","경기화성시","정조효문화제","333073000","0","0","0","0","0","0","0","0","0","333073000","0","0","0","0"
"148","경기","4134000","경기화성시","화성시민체육대회","0","851865000","0","0","0","0","0","0","0","0","0","851865000","0","0","0"
"149","경기","4117000","경기평택시","경기도 체육대회","0","1158232000","0","0","0","0","200000000","0","0","0","0","958232000","0","0","0"
"150","경기","4117000","경기평택시","평택 아시아 역도 선수권대회","0","585262000","0","0","0","0","350000000","0","0","0","0","235262000","0","0","0"
"151","경기","4117000","경기평택시","평택시민 뮤직페스티벌","0","297803000","0","0","0","0","0","0","0","0","0","297803000","0","0","0"
"152","경기","4117000","경기평택시","평택항 마라톤 대회","0","352122000","0","0","0","0","0","0","0","0","0","352122000","0","0","0"
"153","경기","4125000","경기시흥시","갯골축제","304122470","306731000","0","0","0","2224000","5189000","0","0","0","301898470","301542000","0","0","0"
"154","경기","4125000","경기시흥시","시민의날체육대회","0","300000000","0","0","0","0","0","0","0","0","0","300000000","0","0","0"
"155","경기","4130000","경기파주시","DMZ 세계평화콘서트","1500000000","0","0","0","0","0","0","0","0","0","1500000000","0","0","0","0"
"156","경기","4130000","경기파주시","DMZ평화콘서트","700000000","450000000","0","0","0","0","0","0","0","0","700000000","450000000","0","0","0"
"157","경기","4130000","경기파주시","천지진동 페스티벌","500000000","0","0","0","0","0","0","0","0","0","500000000","0","0","0","0"
"158","경기","4130000","경기파주시","파주개성인삼축제","340000000","390000000","0","0","0","0","0","0","0","0","340000000","390000000","0","0","0"
"159","경기","4130000","경기파주시","파주북소리","1000000000","1089578000","0","0","0","3033510","0","0","0","0","996966490","1089578000","0","0","0"
"160","경기","4130000","경기파주시","파주장단콩축제","368826000","360000000","0","0","0","0","0","0","0","0","368826000","360000000","0","0","0"
"161","경기","4126000","경기군포시","군포 철쭉대축제","350000000","399999000","0","0","0","0","0","0","0","0","350000000","399999000","0","0","0"
"162","경기","4135000","경기광주시","광주 왕실 도자기 축제","510000000","571289000","0","0","0","70000000","195000000","0","0","0","440000000","376289000","0","0","0"
"163","경기","4135000","경기광주시","제12회 광주 시민의 날","0","438522000","0","0","0","0","0","0","0","0","0","438522000","0","0","0"
"164","경기","4131000","경기이천시","이천도자기축제","494697000","1120202000","0","0","0","85302000","152606000","0","0","0","409395000","967596000","0","0","0"
"165","경기","4131000","경기이천시","이천쌀문화축제","850000000","625000000","0","0","0","450000000","225000000","0","0","0","400000000","400000000","0","0","0"
"166","경기","4124000","경기오산시","제3회 뷰티 힐링 페스티벌","406075860","366000000","0","0","0","100000000","100000000","0","0","0","306075860","266000000","0","0","0"
"167","경기","4122000","경기구리시","세계3쿠션 당구월드컵 개최","350000000","0","0","0","0","0","0","0","0","0","350000000","0","0","0","0"
"168","경기","4132000","경기안성시","안성맞춤 남사당 바우덕이 축제","971685870","7777644000","0","0","0","0","6117127000","0","0","0","971685870","1660517000","0","0","0"
"169","경기","4137000","경기포천시","2012 포 천 세 계 대 학  태권도대회","0","924059000","0","0","0","0","0","0","0","0","0","924059000","0","0","0"
"170","경기","4128000","경기하남시","하남시민의 날 체육대회","0","319992000","0","0","0","0","0","0","0","0","0","319992000","0","0","0"
"171","경기","4121000","경기과천시","과천축제","1169223540","1124566000","0","0","0","0","0","0","0","0","1169223540","1124566000","0","0","0"
"172","경기","4172000","경기여주군","여주도자기 축제","480000000","600000000","0","0","0","0","0","0","0","0","480000000","600000000","0","0","0"
"173","경기","4178000","경기양평군","경기 레포츠 페스티벌 in  양평","321538570","369610000","0","0","0","100000000","120000000","0","0","0","221538570","249610000","0","0","0"
"174","경기","4178000","경기양평군","양평 산나물 한우 축제","579206680","471461000","0","0","0","0","0","0","0","0","579206680","471461000","0","0","0"
"175","경기","4177000","경기가평군","군민의 날읍면체육대회","0","300000000","0","0","0","0","0","0","0","0","0","300000000","0","0","0"
"176","경기","4177000","경기가평군","자라섬 국제재즈페스티벌","1050000000","949984000","0","0","0","241102014","242820000","0","0","0","808897986","707164000","0","0","0"
"177","경기","4177000","경기가평군","자라섬씽씽겨울축제","2458059640","2745536000","0","0","0","1088164200","1266714000","0","0","0","1369895440","1478822000","0","0","0"
"178","경기","4175000","경기연천군","연천전곡리 구석기축제","876000000","1025000000","0","0","0","25644000","25644000","0","0","0","850356000","999356000","0","0","0"
"179","경기","4175000","경기연천군","제59회경기도체육대회","1322599965","0","0","0","0","200000000","0","0","0","0","1122599965","0","0","0","0"
"180","강원","4200000","강원본청","2014 GTI국제무역투자박람회","1637800000","0","0","0","0","900000000","0","0","0","0","737800000","0","0","0","0"
"181","강원","4200000","강원본청","강원국제민속예술축전","1704722000","0","0","0","0","681888000","0","0","0","0","1022834000","0","0","0","0"
"182","강원","4200000","강원본청","대관령국제음악제","1768650000","1863646000","0","0","0","600000000","500000000","0","0","0","1168650000","1363646000","0","0","0"
"183","강원","4200000","강원본청","드림프로그램","996472000","0","0","0","0","600000000","0","0","0","0","396472000","0","0","0","0"
"184","강원","4200000","강원본청","왁자지껄 전통시장 마케팅","824983000","0","0","0","0","0","0","0","0","0","824983000","0","0","0","0"
"185","강원","4211000","강원춘천시","2012 춘천마임축제","0","443000000","0","0","0","0","194000000","0","0","0","0","249000000","0","0","0"
"186","강원","4211000","강원춘천시","2012 춘천월드레저대회","0","2700000000","0","0","0","0","900000000","0","0","0","0","1800000000","0","0","0"
"187","강원","4211000","강원춘천시","2014 춘천닭갈비막국수축제","449961000","420000000","0","0","0","40000000","20000000","0","0","0","409961000","400000000","0","0","0"
"188","강원","4211000","강원춘천시","2014 춘천마임축제","345000000","0","0","0","0","194000000","0","0","0","0","151000000","0","0","0","0"
"189","강원","4211000","강원춘천시","춘천오픈국제태권도대회","677089000","0","0","0","0","360000000","0","0","0","0","317089000","0","0","0","0"
"190","강원","4212000","강원원주시","원주다이내믹페스티벌","699318440","612432000","0","0","0","0","0","0","0","0","699318440","612432000","0","0","0"
"191","강원","4213000","강원강릉시","2012강릉ICCN 세계무형문화축전","0","2843311000","0","0","0","0","2137892000","0","0","0","0","705419000","0","0","0"
"192","강원","4213000","강원강릉시","강릉 단오제","1087031000","1004979000","0","0","0","0","0","0","0","0","1087031000","1004979000","0","0","0"
"193","강원","4213000","강원강릉시","강릉바다축제","0","100000000","0","0","0","0","50000000","0","0","0","0","50000000","0","0","0"
"194","강원","4214000","강원동해시","동해무릉제","300000000","300000000","0","0","0","0","0","0","0","0","300000000","300000000","0","0","0"
"195","강원","4215000","강원태백시","전국추계대학축구연맹전","329114300","310000000","0","0","0","0","0","0","0","0","329114300","310000000","0","0","0"
"196","강원","4215000","강원태백시","태백산눈축제","821793000","803272000","0","0","0","299618000","422420000","0","0","0","522175000","380852000","0","0","0"
"197","강원","4215000","강원태백시","태백제","422998000","350726000","0","0","0","0","0","0","0","0","422998000","350726000","0","0","0"
"198","강원","4216000","강원속초시","대한민국음악대향연","713093040","726528000","0","0","0","0","0","0","0","0","713093040","726528000","0","0","0"
"199","강원","4216000","강원속초시","설악문화제","524467730","484625000","0","0","0","20000000","0","0","0","0","504467730","484625000","0","0","0"
"200","강원","4217000","강원삼척시","기줄다리기와 함께하는 삼척정월대보름제","442788000","454384000","0","0","0","0","0","0","0","0","442788000","454384000","0","0","0"
"201","강원","4217000","강원삼척시","삼척 황영조 국제마라톤대회","348059000","399787000","0","0","0","0","0","0","0","0","348059000","399787000","0","0","0"
"202","강원","4217000","강원삼척시","이사부역사문화축전","449999330","685153000","0","0","0","50000000","50000000","0","0","0","399999330","635153000","0","0","0"
"203","강원","4271000","강원홍천군","홍천강 꽁꽁축제","1000000000","0","0","0","0","386290000","0","0","0","0","613710000","0","0","0","0"
"204","강원","4272000","강원횡성군","횡성한우축제","1551066000","1577268000","0","0","0","20000000","20000000","0","0","0","1531066000","1557268000","0","0","0"
"205","강원","4273000","강원영월군","김삿갓문화제","310000000","0","0","0","0","0","0","0","0","0","310000000","0","0","0","0"
"206","강원","4273000","강원영월군","단종문화제","770000000","686186000","0","0","0","300000000","220000000","0","0","0","470000000","466186000","0","0","0"
"207","강원","4273000","강원영월군","동강국제사진제","511689000","531366000","0","0","0","145000000","70000000","0","0","0","366689000","461366000","0","0","0"
"208","강원","4273000","강원영월군","동강축제","389699000","397336000","0","0","0","0","0","0","0","0","389699000","397336000","0","0","0"
"209","강원","4273000","강원영월군","영월국제박물관포럼","695165000","0","0","0","0","434479000","0","0","0","0","260686000","0","0","0","0"
"210","강원","4274000","강원평창군","오대산문화축전","400000000","0","0","0","0","90000000","0","0","0","0","310000000","0","0","0","0"
"211","강원","4274000","강원평창군","탄허대종사 탄신 100주년 기념사업","600000000","0","0","0","0","460000000","0","0","0","0","140000000","0","0","0","0"
"212","강원","4274000","강원평창군","평창송어축제","0","362000000","0","0","0","0","6000000","0","0","0","0","356000000","0","0","0"
"213","강원","4274000","강원평창군","평창효석문화제","352000000","0","0","0","0","99000000","0","0","0","0","253000000","0","0","0","0"
"214","강원","4275000","강원정선군","강원도민생활체육대회","0","819842000","0","0","0","0","0","0","0","0","0","819842000","0","0","0"
"215","강원","4275000","강원정선군","대한민국 아리랑 대축제, 정선아리랑제","979000000","600000000","0","0","0","429000000","50000000","0","0","0","550000000","550000000","0","0","0"
"216","강원","4276000","강원철원군","강원도민체육대회","0","2143131000","0","0","0","0","50000000","0","0","0","0","2093131000","0","0","0"
"217","강원","4276000","강원철원군","철원화강 다슬기축제","509284140","511730000","0","0","0","10000000","10000000","0","0","0","499284140","501730000","0","0","0"
"218","강원","4276000","강원철원군","태봉제","465240800","447322000","0","0","0","0","0","0","0","0","465240800","447322000","0","0","0"
"219","강원","4277000","강원화천군","물의 나라 화천 쪽배 축제","683788718","687217000","0","0","0","217052000","262860000","0","0","0","466736718","424357000","0","0","0"
"220","강원","4277000","강원화천군","얼음나라 화천 산천어 축제","2962367093","2688559000","0","0","0","2987481422","2030726000","0","0","0","-25114329","657833000","0","0","0"
"221","강원","4278000","강원양구군","배꼽축제","340134000","353573000","0","0","0","0","6048000","0","0","0","340134000","347525000","0","0","0"
"222","강원","4279000","강원인제군","만해축전","560000000","0","0","0","0","150000000","0","0","0","0","410000000","0","0","0","0"
"223","강원","4279000","강원인제군","빙어축제","1080000000","1032700000","0","0","0","31000000","73532000","0","0","0","1049000000","959168000","0","0","0"
"224","강원","4279000","강원인제군","합강문화제","449672000","464133000","0","0","0","0","0","0","0","0","449672000","464133000","0","0","0"
"225","강원","4280000","강원고성군","고성군민의 날 및 수성문화제","363000000","360000000","0","0","0","0","0","0","0","0","363000000","360000000","0","0","0"
"226","강원","4280000","강원고성군","고성명태축제","497319000","448000000","0","0","0","20000000","0","0","0","0","477319000","448000000","0","0","0"
"227","강원","4281000","강원양양군","양양 송이 축제","709785570","709945000","0","0","0","408942779","414797000","0","0","0","300842791","295148000","0","0","0"
"228","강원","4281000","강원양양군","현산 문화제","375000000","343000000","0","0","0","0","0","0","0","0","375000000","343000000","0","0","0"
"229","충북","4300000","충북본청","2013 오송화장품뷰티세계박람회","22309616807","0","0","0","0","6981457000","0","0","0","0","15328159807","0","0","0","0"
"230","충북","4300000","충북본청","중국인유학생페스티벌","1018558370","0","0","0","0","500000000","0","0","0","0","518558370","0","0","0","0"
"231","충북","4312000","충북충주시","우륵문화제","399106000","0","0","0","0","0","0","0","0","0","399106000","0","0","0","0"
"232","충북","4312000","충북충주시","제42회 우륵문화제","0","300000000","0","0","0","0","0","0","0","0","0","300000000","0","0","0"
"233","충북","4312000","충북충주시","충주세계무술축제","1952000000","2200000000","0","0","0","352000000","300000000","0","0","0","1600000000","1900000000","0","0","0"
"234","충북","4312000","충북충주시","충주호수축제","466570000","476948000","0","0","0","50000000","20000000","0","0","0","416570000","456948000","0","0","0"
"235","충북","4313000","충북제천시","세계영상총회","470662000","0","0","0","0","141199000","0","0","0","0","329463000","0","0","0","0"
"236","충북","4313000","충북제천시","제2회 대한민국 평생학습박람회","1474843750","0","0","0","0","886415630","0","0","0","0","588428120","0","0","0","0"
"237","충북","4313000","충북제천시","제천국제음악영화제","1480000000","1250000000","0","0","0","250000000","250000000","0","0","0","1230000000","1000000000","0","0","0"
"238","충북","4313000","충북제천시","제천한방 바이오박람회","899891000","898872000","0","0","0","376426080","367900000","0","0","0","523464920","530972000","0","0","0"
"239","충북","4313000","충북제천시","추계 한국중등(U-15)축구연맹전","600000000","0","0","0","0","0","0","0","0","0","600000000","0","0","0","0"
"240","충북","4372000","충북보은군","보은대추축제","854832000","748149000","0","0","0","50000000","40000000","0","0","0","804832000","708149000","0","0","0"
"241","충북","4374000","충북영동군","대한민국와인축제","330000000","292998000","0","0","0","210000000","195000000","0","0","0","120000000","97998000","0","0","0"
"242","충북","4374000","충북영동군","영동난계국악축제","720000000","920000000","0","0","0","100000000","300000000","0","0","0","620000000","620000000","0","0","0"
"243","충북","4374000","충북영동군","영동포도축제","460000000","430000000","0","0","0","70000000","0","0","0","0","390000000","430000000","0","0","0"
"244","충북","4379000","충북증평군","증평인삼골축제","350000000","300000000","0","0","0","0","0","0","0","0","350000000","300000000","0","0","0"
"245","충북","4375000","충북진천군","생거진천 문화축제","354652000","324655000","0","0","0","0","0","0","0","0","354652000","324655000","0","0","0"
"246","충북","4376000","충북괴산군","괴산고추축제","628000000","659644000","0","0","0","152000000","84000000","0","0","0","476000000","575644000","0","0","0"
"247","충북","4377000","충북음성군","도민체육대회","1909893090","0","0","0","0","250000000","0","0","0","0","1659893090","0","0","0","0"
"248","충북","4377000","충북음성군","설성문화제","325929850","330000000","0","0","0","0","0","0","0","0","325929850","330000000","0","0","0"
"249","충북","4377000","충북음성군","음성품바축제","316000000","0","0","0","0","30000000","0","0","0","0","286000000","0","0","0","0"
"250","충북","4378000","충북단양군","소백산철쭉제","530000000","520000000","0","0","0","30000000","20000000","0","0","0","500000000","500000000","0","0","0"
"251","충북","4378000","충북단양군","온달문화축제","400000000","300000000","0","0","0","0","0","0","0","0","400000000","300000000","0","0","0"
"252","충남","4400000","충남본청","백제문화제","2420000000","0","0","0","0","0","0","0","0","0","2420000000","0","0","0","0"
"253","충남","4400000","충남본청","제58회 백제문화제","0","2250000000","0","0","0","0","0","0","0","0","0","2250000000","0","0","0"
"254","충남","4411000","충남천안시","2013년 천안국제웰빙식품엑스포","8773402000","0","0","0","0","4511131000","0","0","0","0","4262271000","0","0","0","0"
"255","충남","4411000","충남천안시","기획공연","500000000","0","0","0","0","303834000","0","0","0","0","196166000","0","0","0","0"
"256","충남","4411000","충남천안시","대통령배 아마츄어 e스포츠대회","652402000","0","0","0","0","360000000","0","0","0","0","292402000","0","0","0","0"
"257","충남","4411000","충남천안시","대한민국축구 국가대표 경기","300000000","0","0","0","0","0","0","0","0","0","300000000","0","0","0","0"
"258","충남","4411000","충남천안시","시승격 50주년기념 KBS열린음악회 개최","300000000","0","0","0","0","0","0","0","0","0","300000000","0","0","0","0"
"259","충남","4411000","충남천안시","예술의전당개관기념공연","0","392200000","0","0","0","0","0","0","0","0","0","392200000","0","0","0"
"260","충남","4411000","충남천안시","천안시민체육대회","817417000","0","0","0","0","0","0","0","0","0","817417000","0","0","0","0"
"261","충남","4411000","충남천안시","천안흥타령춤축제","2277150000","2328275000","0","0","0","535350000","507583000","0","0","0","1741800000","1820692000","0","0","0"
"262","충남","4412000","충남공주시","금강자연미술비엔날레","0","434000000","0","0","0","0","200000000","0","0","0","0","234000000","0","0","0"
"263","충남","4412000","충남공주시","백제문화제","0","1000000000","0","0","0","0","0","0","0","0","0","1000000000","0","0","0"
"264","충남","4413000","충남보령시","보령머드축제","2042358000","1798327000","0","0","0","900000000","600000000","0","0","0","1142358000","1198327000","0","0","0"
"265","충남","4413000","충남보령시","제65회 충청남도민체육대회","410000000","0","0","0","0","0","0","0","0","0","410000000","0","0","0","0"
"266","충남","4414000","충남아산시","2013 대한민국 온천대축제","1119549000","0","0","0","0","120000000","0","0","0","0","999549000","0","0","0","0"
"267","충남","4414000","충남아산시","성웅이순신축제","995403815","1124174000","0","0","0","0","20000000","0","0","0","995403815","1104174000","0","0","0"
"268","충남","4414000","충남아산시","제18회 시민한마음체육대회","492520000","0","0","0","0","0","0","0","0","0","492520000","0","0","0","0"
"269","충남","4415000","충남서산시","제19회 충남장애인체전","686470790","0","0","0","0","120000000","0","0","0","0","566470790","0","0","0","0"
"270","충남","4415000","충남서산시","해미읍성 역사체험 축제","0","700000000","0","0","0","0","0","0","0","0","0","700000000","0","0","0"
"271","충남","4415000","충남서산시","해미읍성역사체험축제","800000000","0","0","0","0","114000000","0","0","0","0","686000000","0","0","0","0"
"272","충남","4416000","충남논산시","강경발효젓갈축제","1300000000","980000000","0","0","0","480257000","225000000","0","0","0","819743000","755000000","0","0","0"
"273","충남","4416000","충남논산시","논산딸기축제","740000000","479991000","0","0","0","40000000","30000000","0","0","0","700000000","449991000","0","0","0"
"274","충남","4417000","충남계룡시","계룡 軍 문화축제","2030000000","1964000000","0","0","0","1200000000","1100000000","0","0","0","830000000","864000000","0","0","0"
"275","충남","4418000","충남당진시","기지시줄다리기 민속축제","554000000","475000000","0","0","0","194000000","95000000","0","0","0","360000000","380000000","0","0","0"
"276","충남","4471000","충남금산군","금산인삼 대도시 순회 특별전","300000000","0","0","0","0","206111000","0","0","0","0","93889000","0","0","0","0"
"277","충남","4471000","충남금산군","금산인삼축제","2082713000","2279481000","0","0","0","300000000","492697000","0","0","0","1782713000","1786784000","0","0","0"
"278","충남","4473000","충남부여군","백제문화제","1718491570","1347098000","0","0","0","0","0","0","0","0","1718491570","1347098000","0","0","0"
"279","충남","4473000","충남부여군","부여서동연꽃축제","513043700","511774000","0","0","0","114000000","66336000","0","0","0","399043700","445438000","0","0","0"
"280","충남","4474000","충남서천군","서천 지명탄생 600주년 기념사업","328009000","0","0","0","0","0","0","0","0","0","328009000","0","0","0","0"
"281","충남","4474000","충남서천군","선셋장항페스티벌","0","499956000","0","0","0","0","0","0","0","0","0","499956000","0","0","0"
"282","충남","4474000","충남서천군","한산모시문화제","479000000","520000000","0","0","0","114000000","63000000","0","0","0","365000000","457000000","0","0","0"
"283","충남","4475000","충남청양군","아시아대학태권도선수권대회","400000000","0","0","0","0","0","0","0","0","0","400000000","0","0","0","0"
"284","충남","4475000","충남청양군","제22회 충청남도민생활체육대회","480000000","0","0","0","0","0","0","0","0","0","480000000","0","0","0","0"
"285","충남","4475000","충남청양군","청양 고추구기자축제","458867000","500000000","0","0","0","249624000","230000000","0","0","0","209243000","270000000","0","0","0"
"286","충남","4476000","충남홍성군","제31회 전국연극제","499751000","0","0","0","0","293500000","0","0","0","0","206251000","0","0","0","0"
"287","충남","4476000","충남홍성군","제65회 충청남도민체육대회","2397707000","0","0","0","0","600000000","0","0","0","0","1797707000","0","0","0","0"
"288","충남","4476000","충남홍성군","홍성내포문화축제","495000000","450000000","0","0","0","60000000","50000000","0","0","0","435000000","400000000","0","0","0"
"289","충남","4477000","충남예산군","예산옛이야기축제","618970610","610000000","0","0","0","70000000","60000000","0","0","0","548970610","550000000","0","0","0"
"290","충남","4477000","충남예산군","제31회 전국연극제","499751130","0","0","0","0","249876000","0","0","0","0","249875130","0","0","0","0"
"291","충남","4478000","충남태안군","제13회 태안군민체육대회","340000000","0","0","0","0","0","0","0","0","0","340000000","0","0","0","0"
"292","전북","4500000","전북본청","2012전북방문의해","0","5485549000","0","0","0","0","2500000000","0","0","0","0","2985549000","0","0","0"
"293","전북","4500000","전북본청","새만금상설공연","1700000000","1700000000","0","0","0","750000000","700000000","0","0","0","950000000","1000000000","0","0","0"
"294","전북","4500000","전북본청","세계서예전북비엔날레","665000000","0","0","0","0","0","0","0","0","0","665000000","0","0","0","0"
"295","전북","4500000","전북본청","전주국제발효식품엑스포","1395000000","0","0","0","0","0","0","0","0","0","1395000000","0","0","0","0"
"296","전북","4500000","전북본청","전주세계소리축제","1650000000","1850000000","0","0","0","0","200000000","0","0","0","1650000000","1650000000","0","0","0"
"297","전북","4500000","전북본청","한국음식관광축제","0","800000000","0","0","0","0","300000000","0","0","0","0","500000000","0","0","0"
"298","전북","4511000","전북전주시","전주국제영화제","2480000000","2190000000","0","0","0","840000000","890000000","0","0","0","1640000000","1300000000","0","0","0"
"299","전북","4511000","전북전주시","전주대사습놀이 전국대회","400000000","350000000","0","0","0","250000000","0","0","0","0","150000000","350000000","0","0","0"
"300","전북","4511000","전북전주시","전주비빔밥축제","400000000","350000000","0","0","0","50000000","50000000","0","0","0","350000000","300000000","0","0","0"
"301","전북","4511000","전북전주시","한옥자원활용 야간상설공연","359940000","0","0","0","0","159940000","0","0","0","0","200000000","0","0","0","0"
"302","전북","4512000","전북군산시","군산새만금국제마라톤","540000000","710000000","0","0","0","20000000","20000000","0","0","0","520000000","690000000","0","0","0"
"303","전북","4512000","전북군산시","군산세계철새축제","0","665110000","0","0","0","0","50000000","0","0","0","0","615110000","0","0","0"
"304","전북","4512000","전북군산시","금석배 전국학생 축구대회","370000000","0","0","0","0","60000000","0","0","0","0","310000000","0","0","0","0"
"305","전북","4512000","전북군산시","설날장사씨름대회","315000000","0","0","0","0","50000000","0","0","0","0","265000000","0","0","0","0"
"306","전북","4513000","전북익산시","2012익산국제돌문화프로젝트","0","800000000","0","0","0","0","500000000","0","0","0","0","300000000","0","0","0"
"307","전북","4513000","전북익산시","2013 익산농업기계 박람회","400000000","0","0","0","0","200000000","0","0","0","0","200000000","0","0","0","0"
"308","전북","4513000","전북익산시","보석대축제","0","445000000","0","0","0","0","0","0","0","0","0","445000000","0","0","0"
"309","전북","4513000","전북익산시","익산서동축제","549764000","603010000","0","0","0","50000000","50000000","0","0","0","499764000","553010000","0","0","0"
"310","전북","4513000","전북익산시","익산천만송이국화축제","549821000","565935000","0","0","0","0","0","0","0","0","549821000","565935000","0","0","0"
"311","전북","4515000","전북남원시","춘향제","875346324","1310487000","0","0","0","0","240000000","0","0","0","875346324","1070487000","0","0","0"
"312","전북","4516000","전북김제시","2013 전라북도민체육대회","909296020","0","0","0","0","200000000","0","0","0","0","709296020","0","0","0","0"
"313","전북","4516000","전북김제시","김제지평선축제","2189666900","1699819000","0","0","0","720000000","420000000","0","0","0","1469666900","1279819000","0","0","0"
"314","전북","4571000","전북완주군","완주와일드푸드축제","549736150","848173000","0","0","0","50000000","50000000","0","0","0","499736150","798173000","0","0","0"
"315","전북","4573000","전북무주군","무주반딧불축제","1596073000","1042853000","0","0","0","537089000","318135000","0","0","0","1058984000","724718000","0","0","0"
"316","전북","4573000","전북무주군","무주산골영화제","300000000","0","0","0","0","53000000","0","0","0","0","247000000","0","0","0","0"
"317","전북","4573000","전북무주군","세계태권도문화엑스포","500000000","530000000","0","0","0","300000000","300000000","0","0","0","200000000","230000000","0","0","0"
"318","전북","4573000","전북무주군","세계태권도청소년캠프","0","306000000","0","0","0","0","266000000","0","0","0","0","40000000","0","0","0"
"319","전북","4574000","전북장수군","장수 한우랑 사과랑 축제","675647370","690573000","0","0","0","50000000","50000000","0","0","0","625647370","640573000","0","0","0"
"320","전북","4575000","전북임실군","임실통합축제","370000000","694366000","0","0","0","0","20000000","0","0","0","370000000","674366000","0","0","0"
"321","전북","4576000","전북순창군","순창장류축제","866000000","841662000","0","0","0","167320000","147738000","0","0","0","698680000","693924000","0","0","0"
"322","전북","4577000","전북고창군","모양성제","340000000","350000000","0","0","0","50000000","0","0","0","0","290000000","350000000","0","0","0"
"323","전북","4578000","전북부안군","부안마실축제","656562020","666259000","0","0","0","50000000","20000000","0","0","0","606562020","646259000","0","0","0"
"324","전남","4600000","전남본청","2012 국제농업박람회","0","7846000000","0","0","0","0","1602000000","0","0","0","0","6244000000","0","0","0"
"325","전남","4600000","전남본청","2012 대한민국 산림박람회","0","969872000","0","0","0","0","484981000","0","0","0","0","484891000","0","0","0"
"326","전남","4600000","전남본청","2012 명량대첩축제","0","1300000000","0","0","0","0","800000000","0","0","0","0","500000000","0","0","0"
"327","전남","4600000","전남본청","2013 F1 코리아 그랑프리","45640847000","49912062000","0","0","0","5000000000","5000000000","0","0","0","40640847000","44912062000","0","0","0"
"328","전남","4600000","전남본청","남도음식문화큰잔치","764404000","0","0","0","0","300000000","0","0","0","0","464404000","0","0","0","0"
"329","전남","4600000","전남본청","대한민국 농업박람회","1216550000","0","0","0","0","0","0","0","0","0","1216550000","0","0","0","0"
"330","전남","4600000","전남본청","명량대첩축제","1251289000","0","0","0","0","800000000","0","0","0","0","451289000","0","0","0","0"
"331","전남","4600000","전남본청","제19회 남도음식문화큰잔치","0","800000000","0","0","0","0","300000000","0","0","0","0","500000000","0","0","0"
"332","전남","4611000","전남목포시","IFSC 목포 스포츠클라이밍 월드컵","0","488317000","0","0","0","0","300000000","0","0","0","0","188317000","0","0","0"
"333","전남","4611000","전남목포시","해양문화축제","726000000","730000000","0","0","0","0","0","0","0","0","726000000","730000000","0","0","0"
"334","전남","4612000","전남여수시","세계불교도우의회 한국대회","0","1800000000","0","0","0","0","1100000000","0","0","0","0","700000000","0","0","0"
"335","전남","4612000","전남여수시","슈퍼모델 선발대회","401500000","0","0","0","0","0","0","0","0","0","401500000","0","0","0","0"
"336","전남","4612000","전남여수시","실크로드 시장단 여수포럼","573252000","0","0","0","0","0","0","0","0","0","573252000","0","0","0","0"
"337","전남","4612000","전남여수시","여수 거북선 축제","707385000","670852000","0","0","0","0","0","0","0","0","707385000","670852000","0","0","0"
"338","전남","4612000","전남여수시","여수 세계합창제","509998000","0","0","0","0","0","0","0","0","0","509998000","0","0","0","0"
"339","전남","4612000","전남여수시","여수국제청소년축제","795559000","800000000","0","0","0","596001000","600000000","0","0","0","199558000","200000000","0","0","0"
"340","전남","4612000","전남여수시","여수세계박람회 문화예술행사","0","3412480000","0","0","0","0","0","0","0","0","0","3412480000","0","0","0"
"341","전남","4612000","전남여수시","여수시민 체육대회","469000000","0","0","0","0","0","0","0","0","0","469000000","0","0","0","0"
"342","전남","4612000","전남여수시","전국 무용제","0","489000000","0","0","0","0","289000000","0","0","0","0","200000000","0","0","0"
"343","전남","4613000","전남순천시","2012에코지오 페스티발","0","480000000","0","0","0","0","0","0","0","0","0","480000000","0","0","0"
"344","전남","4613000","전남순천시","23회 전국무용제 참가","560478710","0","0","0","0","0","0","0","0","0","560478710","0","0","0","0"
"345","전남","4613000","전남순천시","동천 봄빛축제","450000000","0","0","0","0","0","0","0","0","0","450000000","0","0","0","0"
"346","전남","4613000","전남순천시","동천 여름축제","385397000","0","0","0","0","0","0","0","0","0","385397000","0","0","0","0"
"347","전남","4613000","전남순천시","시내일원문화예술행사","1571000000","0","0","0","0","0","0","0","0","0","1571000000","0","0","0","0"
"348","전남","4613000","전남순천시","제16회 순천만 갈대축제","500000000","495000000","0","0","0","118086000","15000000","0","0","0","381914000","480000000","0","0","0"
"349","전남","4613000","전남순천시","제20회남도음식 문화축제","300000000","300000000","0","0","0","0","0","0","0","0","300000000","300000000","0","0","0"
"350","전남","4613000","전남순천시","제2회 순천만세계동물영화제 개최","449279756","0","0","0","0","0","0","0","0","0","449279756","0","0","0","0"
"351","전남","4614000","전남나주시","2012 전남 장애인 체육대회","0","303537000","0","0","0","0","0","0","0","0","0","303537000","0","0","0"
"352","전남","4615000","전남광양시","광양국제매화축제","300000000","305174000","0","0","0","0","15000000","0","0","0","300000000","290174000","0","0","0"
"353","전남","4671000","전남담양군","담양대나무축제","650000000","506438000","0","0","0","650000000","234235000","0","0","0","0","272203000","0","0","0"
"354","전남","4672000","전남곡성군","제12회 곡성심청효문화대축제","0","305000000","0","0","0","0","15000000","0","0","0","0","290000000","0","0","0"
"355","전남","4673000","전남구례군","2012 구례동편제소리축제","0","376000000","0","0","0","0","135000000","0","0","0","0","241000000","0","0","0"
"356","전남","4673000","전남구례군","구례산수유꽃축제","429999110","350000000","0","0","0","0","0","0","0","0","429999110","350000000","0","0","0"
"357","전남","4673000","전남구례군","제21회 전라남도 장애인 체육대회","348440000","0","0","0","0","50000000","0","0","0","0","298440000","0","0","0","0"
"358","전남","4673000","전남구례군","제51회 전라남도 체육대회","0","931469000","0","0","0","0","250000000","0","0","0","0","681469000","0","0","0"
"359","전남","4674000","전남고흥군","고흥 군민의 날 행사","0","441843000","0","0","0","0","0","0","0","0","0","441843000","0","0","0"
"360","전남","4674000","전남고흥군","고흥우주항공축제","426000000","365000000","0","0","0","0","0","0","0","0","426000000","365000000","0","0","0"
"361","전남","4674000","전남고흥군","대종상 단편 영화제","462000000","359000000","0","0","0","190000000","0","0","0","0","272000000","359000000","0","0","0"
"362","전남","4675000","전남보성군","보성다향제녹차대축제","550000000","599338000","0","0","0","0","42000000","0","0","0","550000000","557338000","0","0","0"
"363","전남","4675000","전남보성군","보성차밭빛축제","248000000","0","0","0","0","0","0","0","0","0","248000000","0","0","0","0"
"364","전남","4675000","전남보성군","서편제보성소리축제","225000000","360000000","0","0","0","125000000","135000000","0","0","0","100000000","225000000","0","0","0"
"365","전남","4676000","전남화순군","2012화순.빅터코리아 그랑프리골드및주니어오픈국제배드민턴대회","0","400000000","0","0","0","0","0","0","0","0","0","400000000","0","0","0"
"366","전남","4676000","전남화순군","2013 화순힐링푸드페스티벌","799497000","0","0","0","0","0","0","0","0","0","799497000","0","0","0","0"
"367","전남","4676000","전남화순군","제24회도민생활 체육대회","0","627778000","0","0","0","0","80000000","0","0","0","0","547778000","0","0","0"
"368","전남","4677000","전남장흥군","대한민국통합의학박람회","1300000000","1232107000","0","0","0","600000000","632107000","0","0","0","700000000","600000000","0","0","0"
"369","전남","4677000","전남장흥군","정남진장흥물축제","1476000000","1423000000","0","0","0","76000000","0","0","0","0","1400000000","1423000000","0","0","0"
"370","전남","4677000","전남장흥군","제52회 전라남도 체육대회","1300000000","0","0","0","0","0","0","0","0","0","1300000000","0","0","0","0"
"371","전남","4678000","전남강진군","강진청자축제","1570000000","2065000000","0","0","0","0","800000000","0","0","0","1570000000","1265000000","0","0","0"
"372","전남","4680000","전남영암군","대한민국 한옥건축 박람회","499421000","549293000","0","0","0","200000000","200000000","0","0","0","299421000","349293000","0","0","0"
"373","전남","4680000","전남영암군","왕인국화 축제","556990000","444607000","0","0","0","77763000","101807000","0","0","0","479227000","342800000","0","0","0"
"374","전남","4680000","전남영암군","왕인문화 축제","885000000","904618000","0","0","0","15000000","42000000","0","0","0","870000000","862618000","0","0","0"
"375","전남","4681000","전남무안군","무안연꽃축제","456472540","323689000","0","0","0","0","0","0","0","0","456472540","323689000","0","0","0"
"376","전남","4682000","전남함평군","대한민국 국향대전","892278000","744350000","0","0","0","700070000","639292000","0","0","0","192208000","105058000","0","0","0"
"377","전남","4682000","전남함평군","함평나비대축제","1294267000","1218952000","0","0","0","790350000","1081720000","0","0","0","503917000","137232000","0","0","0"
"378","전남","4683000","전남영광군","2012 전국 장사 씨름대회","0","300000000","0","0","0","0","0","0","0","0","0","300000000","0","0","0"
"379","전남","4685000","전남완도군","2013 완도 장보고축제 (18회)","515000000","0","0","0","0","0","0","0","0","0","515000000","0","0","0","0"
"380","전남","4685000","전남완도군","장보고축제","0","590000000","0","0","0","0","15000000","0","0","0","0","575000000","0","0","0"
"381","전남","4686000","전남진도군","명량대첩 축제","0","400000000","0","0","0","0","0","0","0","0","0","400000000","0","0","0"
"382","전남","4686000","전남진도군","진도 신비의 바닷길 축제","0","600000000","0","0","0","0","0","0","0","0","0","600000000","0","0","0"
"383","전남","4686000","전남진도군","진도신비의바닷길축제","553398000","0","0","0","0","0","0","0","0","0","553398000","0","0","0","0"
"384","경북","4700000","경북본청","2013 전국생활체육대축전","1941911000","0","0","0","0","0","0","0","0","0","1941911000","0","0","0","0"
"385","경북","4700000","경북본청","이스탄불-경주세계문화엑스포","12650000000","0","0","0","0","4800000000","0","0","0","0","7850000000","0","0","0","0"
"386","경북","4711000","경북포항시","KBS열린음악회","342880000","0","0","0","0","0","0","0","0","0","342880000","0","0","0","0"
"387","경북","4711000","경북포항시","국제불빛축제","958000000","896000000","0","0","0","152000000","84000000","0","0","0","806000000","812000000","0","0","0"
"388","경북","4711000","경북포항시","포항스틸아트페스티벌","1200000000","1200000000","0","0","0","700000000","700000000","0","0","0","500000000","500000000","0","0","0"
"389","경북","4711000","경북포항시","포항시시민체육대회","0","592000000","0","0","0","0","0","0","0","0","0","592000000","0","0","0"
"390","경북","4712000","경북경주시","경주 떡과 술잔치","0","730000000","0","0","0","0","55000000","0","0","0","0","675000000","0","0","0"
"391","경북","4712000","경북경주시","경주국제 유소년축구대회","800000000","793405000","0","0","0","25000000","50000000","0","0","0","775000000","743405000","0","0","0"
"392","경북","4712000","경북경주시","경주시민 체육대회 행사","0","745560000","0","0","0","0","0","0","0","0","0","745560000","0","0","0"
"393","경북","4712000","경북경주시","경주코리아오픈국제태권도대회","0","590560000","0","0","0","0","200000000","0","0","0","0","390560000","0","0","0"
"394","경북","4712000","경북경주시","국제펜경주대회","0","405000000","0","0","0","0","200000000","0","0","0","0","205000000","0","0","0"
"395","경북","4712000","경북경주시","동아일보 경주국제마라톤대회","700000000","700000000","0","0","0","200000000","200000000","0","0","0","500000000","500000000","0","0","0"
"396","경북","4712000","경북경주시","보문단지 야외국악공연","0","330000000","0","0","0","0","60000000","0","0","0","0","270000000","0","0","0"
"397","경북","4712000","경북경주시","세계피리축제","0","300000000","0","0","0","0","150000000","0","0","0","0","150000000","0","0","0"
"398","경북","4712000","경북경주시","신라국학 1330주년 기념행사","0","300000000","0","0","0","0","150000000","0","0","0","0","150000000","0","0","0"
"399","경북","4712000","경북경주시","신라문화제","0","342910000","0","0","0","0","0","0","0","0","0","342910000","0","0","0"
"400","경북","4712000","경북경주시","신라소리축제 에밀레전","400000000","0","0","0","0","300000000","0","0","0","0","100000000","0","0","0","0"
"401","경북","4712000","경북경주시","아트경주","0","300000000","0","0","0","0","90000000","0","0","0","0","210000000","0","0","0"
"402","경북","4712000","경북경주시","한류드림페스티벌","700000000","1300000000","0","0","0","200000000","800000000","0","0","0","500000000","500000000","0","0","0"
"403","경북","4712000","경북경주시","화랑대기 전국초등학교 유소년축구대회","890000000","863326000","0","0","0","10000000","0","0","0","0","880000000","863326000","0","0","0"
"404","경북","4713000","경북김천시","2013 김천시민체육대회","983631420","0","0","0","0","0","0","0","0","0","983631420","0","0","0","0"
"405","경북","4713000","경북김천시","김천국제가족연극제","300000000","0","0","0","0","94365000","0","0","0","0","205635000","0","0","0","0"
"406","경북","4713000","경북김천시","제23회 경북도민생활체육대회 개최","482246750","0","0","0","0","120000000","0","0","0","0","362246750","0","0","0","0"
"407","경북","4713000","경북김천시","제3회 경상북도평생학습축제","0","288830000","0","0","0","0","144415000","0","0","0","0","144415000","0","0","0"
"408","경북","4713000","경북김천시","제51회 경북도민체육대회","4160058600","0","0","0","0","1700000000","0","0","0","0","2460058600","0","0","0","0"
"409","경북","4713000","경북김천시","창작뮤지컬 징","609507200","0","0","0","0","200000000","0","0","0","0","409507200","0","0","0","0"
"410","경북","4714000","경북안동시","K-뮤지컬 이육사","0","400000000","0","0","0","0","0","0","0","0","0","400000000","0","0","0"
"411","경북","4714000","경북안동시","실경뮤지컬 왕의나라","600000000","1198865000","0","0","0","252096000","526024000","0","0","0","347904000","672841000","0","0","0"
"412","경북","4714000","경북안동시","실경수상뮤지컬 부용지애","700000000","800000000","0","0","0","253969015","232836000","0","0","0","446030985","567164000","0","0","0"
"413","경북","4714000","경북안동시","안동국제탈춤페스티벌","1700000000","1700000000","0","0","0","600000000","600000000","0","0","0","1100000000","1100000000","0","0","0"
"414","경북","4714000","경북안동시","안동시민체육대회","496000000","400000000","0","0","0","0","0","0","0","0","496000000","400000000","0","0","0"
"415","경북","4714000","경북안동시","전국생활체육대축전","1466273709","0","0","0","0","0","0","0","0","0","1466273709","0","0","0","0"
"416","경북","4715000","경북구미시","2012 아시아레슬링 선수권대회","0","410000000","0","0","0","0","60000000","0","0","0","0","350000000","0","0","0"
"417","경북","4715000","경북구미시","대한민국 정수대전","340000000","300000000","0","0","0","130000000","130000000","0","0","0","210000000","170000000","0","0","0"
"418","경북","4715000","경북구미시","마이스터 대전","300000000","300000000","0","0","0","200000000","200000000","0","0","0","100000000","100000000","0","0","0"
"419","경북","4715000","경북구미시","제1회 경상북도 평생학습 박람회","380000000","0","0","0","0","180000000","0","0","0","0","200000000","0","0","0","0"
"420","경북","4715000","경북구미시","제22회 경북도민생활 체육대회","0","324386000","0","0","0","0","100000000","0","0","0","0","224386000","0","0","0"
"421","경북","4715000","경북구미시","제50회 경상북도 도민체육대회","0","5145690000","0","0","0","0","1500000000","0","0","0","0","3645690000","0","0","0"
"422","경북","4716000","경북영주시","선비문화축제","449902000","500000000","0","0","0","0","0","0","0","0","449902000","500000000","0","0","0"
"423","경북","4716000","경북영주시","실경무섬마을 상설공연","600000000","0","0","0","0","390000000","0","0","0","0","210000000","0","0","0","0"
"424","경북","4716000","경북영주시","영주소백산마라톤 대회","0","310000000","0","0","0","0","130000000","0","0","0","0","180000000","0","0","0"
"425","경북","4716000","경북영주시","영주시민 체육대회","307750560","310000000","0","0","0","0","0","0","0","0","307750560","310000000","0","0","0"
"426","경북","4716000","경북영주시","영주풍기인삼축제","800000000","800000000","0","0","0","300000000","300000000","0","0","0","500000000","500000000","0","0","0"
"427","경북","4717000","경북영천시","영천과일축제","330056000","299127000","0","0","0","0","0","0","0","0","330056000","299127000","0","0","0"
"428","경북","4717000","경북영천시","영천보현산별빛축제","394772000","410331000","0","0","0","38000000","35000000","0","0","0","356772000","375331000","0","0","0"
"429","경북","4717000","경북영천시","영천한약축제","743678000","727944000","0","0","0","150000000","150000000","0","0","0","593678000","577944000","0","0","0"
"430","경북","4718000","경북상주시","2012 추석장사 씨름대회","0","300000000","0","0","0","0","0","0","0","0","0","300000000","0","0","0"
"431","경북","4718000","경북상주시","2013 감고을상주이야기축제","617360000","0","0","0","0","0","0","0","0","0","617360000","0","0","0","0"
"432","경북","4718000","경북상주시","2013 낙동강 국제 물주간 행사","400000000","0","0","0","0","0","0","0","0","0","400000000","0","0","0","0"
"433","경북","4718000","경북상주시","상주감고을이야기축제","0","642989000","0","0","0","0","35000000","0","0","0","0","607989000","0","0","0"
"434","경북","4718000","경북상주시","상주농업기계박람회","600000000","724940000","0","0","0","0","224940000","0","0","0","600000000","500000000","0","0","0"
"435","경북","4719000","경북문경시","문경사과축제","398113000","376252000","0","0","0","0","0","0","0","0","398113000","376252000","0","0","0"
"436","경북","4719000","경북문경시","문경전통찻사발축제","1000000000","1300000000","0","0","0","600000000","600000000","0","0","0","400000000","700000000","0","0","0"
"437","경북","4720000","경북경산시","경산자인단오제","500000000","391460000","0","0","0","0","20000000","0","0","0","500000000","371460000","0","0","0"
"438","경북","4772000","경북의성군","제4회 의성세계연축제","685822000","593424000","0","0","0","510000000","300000000","0","0","0","175822000","293424000","0","0","0"
"439","경북","4773000","경북청송군","청송사과축제","443776000","453991000","0","0","0","75000000","17582000","0","0","0","368776000","436409000","0","0","0"
"440","경북","4773000","경북청송군","청송아이스클라이밍월드컵","420000000","0","0","0","0","0","0","0","0","0","420000000","0","0","0","0"
"441","경북","4774000","경북영양군","대한민국산채박람회","300000000","300000000","0","0","0","150000000","150000000","0","0","0","150000000","150000000","0","0","0"
"442","경북","4774000","경북영양군","영양고추 H.O.T Festival","371005000","367390000","0","0","0","0","0","0","0","0","371005000","367390000","0","0","0"
"443","경북","4774000","경북영양군","영양산채한마당","462522000","470000000","0","0","0","56000000","75000000","0","0","0","406522000","395000000","0","0","0"
"444","경북","4775000","경북영덕군","영덕대게축제","605000000","648000000","0","0","0","75000000","670000000","0","0","0","530000000","-22000000","0","0","0"
"445","경북","4775000","경북영덕군","제50회 춘계 한국중등축구연맹전","550000000","97489000","0","0","0","0","0","0","0","0","550000000","97489000","0","0","0"
"446","경북","4775000","경북영덕군","제9회 한국중등축구연맹회장배 겸 경상북도배 국제축구대회 대회 운영","500000000","0","0","0","0","200000000","0","0","0","0","300000000","0","0","0","0"
"447","경북","4776000","경북청도군","청도반시축제","355590000","334985000","0","0","0","56000000","35000000","0","0","0","299590000","299985000","0","0","0"
"448","경북","4776000","경북청도군","청도소싸움축제","906691000","892811000","0","0","0","0","0","0","0","0","906691000","892811000","0","0","0"
"449","경북","4777000","경북고령군","대가야체험축제","1033500000","979000000","0","0","0","327999000","105262000","0","0","0","705501000","873738000","0","0","0"
"450","경북","4777000","경북고령군","문화콘텐츠 제작","300000000","300000000","0","0","0","120000000","150000000","0","0","0","180000000","150000000","0","0","0"
"451","경북","4778000","경북성주군","2013 성주생명문화축제","600000000","600000000","0","0","0","0","0","0","0","0","600000000","600000000","0","0","0"
"452","경북","4779000","경북칠곡군","낙동강세계평화 문화 대축전","1708864000","0","0","0","0","1044000000","0","0","0","0","664864000","0","0","0","0"
"453","경북","4780000","경북예천군","2012 예천곤충바이오엑스포","0","5195571000","0","0","0","0","5146222000","0","0","0","0","49349000","0","0","0"
"454","경북","4780000","경북예천군","경북 농업경영인대회 개최지원","310000000","0","0","0","0","0","0","0","0","0","310000000","0","0","0","0"
"455","경북","4781000","경북봉화군","백두대간 우드아트페어","0","274751000","0","0","0","0","84345000","0","0","0","0","190406000","0","0","0"
"456","경북","4781000","경북봉화군","봉화송이축제","457534000","392236000","0","0","0","0","0","0","0","0","457534000","392236000","0","0","0"
"457","경북","4781000","경북봉화군","봉화은어축제","873001000","775302000","0","0","0","152000000","84000000","0","0","0","721001000","691302000","0","0","0"
"458","경북","4782000","경북울진군","2013 울진대게와 붉은대게 축제","0","291003000","0","0","0","0","0","0","0","0","0","291003000","0","0","0"
"459","경북","4782000","경북울진군","울진금강송 파리 사진전","0","299680000","0","0","0","0","90000000","0","0","0","0","209680000","0","0","0"
"460","경북","4782000","경북울진군","울진워터피아 페스티벌","351900000","335000000","0","0","0","56000000","35000000","0","0","0","295900000","300000000","0","0","0"
"461","경북","4782000","경북울진군","제13회 경북과학축전 및 2013 경북청소년페스티벌 행사용역","399255560","0","0","0","0","280000000","0","0","0","0","119255560","0","0","0","0"
"462","경북","4782000","경북울진군","제41회 군민체육대회","0","300000000","0","0","0","0","0","0","0","0","0","300000000","0","0","0"
"463","경북","4782000","경북울진군","제48회 춘추계 한국고등학교축구연맹전","0","497518000","0","0","0","0","100000000","0","0","0","0","397518000","0","0","0"
"464","경북","4782000","경북울진군","제5회 코리아컵 국제요트대회2012","0","500000000","0","0","0","0","150000000","0","0","0","0","350000000","0","0","0"
"465","경북","4782000","경북울진군","춘추계 한국고교 축구연맹전","498222000","0","0","0","0","0","0","0","0","0","498222000","0","0","0","0"
"466","경북","4782000","경북울진군","코리아컵 국제요트대회","500000000","0","0","0","0","0","0","0","0","0","500000000","0","0","0","0"
"467","경남","4800000","경남본청","2013대장경세계문화축전","16477008123","0","0","0","0","6717219000","0","0","0","0","9759789123","0","0","0","0"
"468","경남","4800000","경남본청","국제조선해양산업전","0","950000000","0","0","0","0","0","0","0","0","0","950000000","0","0","0"
"469","경남","4800000","경남본청","대한민국 국제보트쇼","1304943292","2340687000","0","0","0","0","0","0","0","0","1304943292","2340687000","0","0","0"
"470","경남","4800000","경남본청","전국생활체육 대축전 어르신대회","0","750000000","0","0","0","0","0","0","0","0","0","750000000","0","0","0"
"471","경남","4811000","경남창원시","2012창원평생학습&과학축전","0","386703000","0","0","0","0","0","0","0","0","0","386703000","0","0","0"
"472","경남","4811000","경남창원시","2013 창원세계아동문학 축전","407677000","0","0","0","0","0","0","0","0","0","407677000","0","0","0","0"
"473","경남","4811000","경남창원시","2014 창원페스티벌","500000000","500000000","0","0","0","5000000","5000000","0","0","0","495000000","495000000","0","0","0"
"474","경남","4811000","경남창원시","2014창원조각 비엔날레","0","1566614000","0","0","0","0","820000000","0","0","0","0","746614000","0","0","0"
"475","경남","4811000","경남창원시","가고파 국화축제","887000000","987000000","0","0","0","116000000","0","0","0","0","771000000","987000000","0","0","0"
"476","경남","4811000","경남창원시","군항제","939990000","518000000","0","0","0","40000000","50000000","0","0","0","899990000","468000000","0","0","0"
"477","경남","4811000","경남창원시","제12회 창원 IAEC 세계총회","0","2425304000","0","0","0","0","1100000000","0","0","0","0","1325304000","0","0","0"
"478","경남","4811000","경남창원시","희망콘서트 우리는","0","300000000","0","0","0","0","0","0","0","0","0","300000000","0","0","0"
"479","경남","4813000","경남진주시","개천예술제","1004520530","918028000","0","0","0","70000000","32000000","0","0","0","934520530","886028000","0","0","0"
"480","경남","4813000","경남진주시","민속소싸움대회","0","592965000","0","0","0","0","12000000","0","0","0","0","580965000","0","0","0"
"481","경남","4813000","경남진주시","진주국제농식품박람회","2782697980","1423859000","0","0","0","700000000","0","0","0","0","2082697980","1423859000","0","0","0"
"482","경남","4813000","경남진주시","진주국화전시회","324863928","0","0","0","0","0","0","0","0","0","324863928","0","0","0","0"
"483","경남","4813000","경남진주시","진주남강유등축제","2631481808","2682823000","0","0","0","800000000","1000000000","0","0","0","1831481808","1682823000","0","0","0"
"484","경남","4813000","경남진주시","코리아 드라마 페스티벌","1700000000","1178000000","0","0","0","1500000000","978000000","0","0","0","200000000","200000000","0","0","0"
"485","경남","4815000","경남통영시","윤이상국제음악콩쿠르","360470000","410000000","0","0","0","310000000","310000000","0","0","0","50470000","100000000","0","0","0"
"486","경남","4815000","경남통영시","이순신장군배 국제요트대회","832987820","972999000","0","0","0","632996480","776194000","0","0","0","199991340","196805000","0","0","0"
"487","경남","4815000","경남통영시","통영 ITU 트라이애슬론 월드컵","392500000","405000000","0","0","0","112500000","125000000","0","0","0","280000000","280000000","0","0","0"
"488","경남","4815000","경남통영시","통영국제음악제","1374600000","1374600000","0","0","0","100000000","100000000","0","0","0","1274600000","1274600000","0","0","0"
"489","경남","4815000","경남통영시","통영한산대첩축제","1016000000","1077000000","0","0","0","116000000","77000000","0","0","0","900000000","1000000000","0","0","0"
"490","경남","4816000","경남사천시","경남사천 항공우주 엑스포","710161000","772883000","0","0","0","266310000","300000000","0","0","0","443851000","472883000","0","0","0"
"491","경남","4816000","경남사천시","경상남도민 체육대회","1914640000","0","0","0","0","40000000","0","0","0","0","1874640000","0","0","0","0"
"492","경남","4816000","경남사천시","사천세계타악축제","552500000","550000000","0","0","0","130000000","150000000","0","0","0","422500000","400000000","0","0","0"
"493","경남","4817000","경남김해시","가야문화축제","779436000","681990000","0","0","0","0","31995000","0","0","0","779436000","649995000","0","0","0"
"494","경남","4817000","경남김해시","김해시민체육대회","0","511186000","0","0","0","0","16186000","0","0","0","0","495000000","0","0","0"
"495","경남","4818000","경남밀양시","밀양아리랑대축제","335590000","361889000","0","0","0","10000000","5000000","0","0","0","325590000","356889000","0","0","0"
"496","경남","4818000","경남밀양시","밀양여름공연예술축제","343000000","388667000","0","0","0","93100000","103070000","0","0","0","249900000","285597000","0","0","0"
"497","경남","4819000","경남거제시","거제섬꽃축제","312263000","309958000","0","0","0","136587000","103608000","0","0","0","175676000","206350000","0","0","0"
"498","경남","4819000","경남거제시","도민체육대회개최","0","1411544000","0","0","0","0","50000000","0","0","0","0","1361544000","0","0","0"
"499","경남","4819000","경남거제시","세계조선해양축제","0","905375000","0","0","0","0","0","0","0","0","0","905375000","0","0","0"
"500","경남","4819000","경남거제시","해양스포츠 바다로세계로","480000000","480000000","0","0","0","0","0","0","0","0","480000000","480000000","0","0","0"
"501","경남","4820000","경남양산시","2014 양산삽량문화축전","579901000","564793000","0","0","0","20000000","5000000","0","0","0","559901000","559793000","0","0","0"
"502","경남","4871000","경남의령군","민속소싸움 대회","360000000","360000000","0","0","0","12000000","12000000","0","0","0","348000000","348000000","0","0","0"
"503","경남","4871000","경남의령군","의병의 날 기념축제","614311000","809000000","0","0","0","59550000","100000000","0","0","0","554761000","709000000","0","0","0"
"504","경남","4872000","경남함안군","군민의 날.아라제","409999846","405667000","0","0","0","0","5000000","0","0","0","409999846","400667000","0","0","0"
"505","경남","4874000","경남고성군","2012경남고성공룡세계엑스포","0","6661847000","0","0","0","0","11457424000","0","0","0","0","-4795577000","0","0","0"
"506","경남","4875000","경남남해군","이충무공 순국 제 414주년 추념 이순신 순국제전","0","299835000","0","0","0","0","150000000","0","0","0","0","149835000","0","0","0"
"507","경남","4875000","경남남해군","전국유소년 축구대회","300000000","0","0","0","0","0","0","0","0","0","300000000","0","0","0","0"
"508","경남","4875000","경남남해군","제8회 보물섬 마늘축제","0","466909000","0","0","0","0","32000000","0","0","0","0","434909000","0","0","0"
"509","경남","4875000","경남남해군","제9회 보물섬 마늘축제","524628000","0","0","0","0","40000000","0","0","0","0","484628000","0","0","0","0"
"510","경남","4876000","경남하동군","하동야생차 문화축제","701687000","1204043000","0","0","0","0","375000000","0","0","0","701687000","829043000","0","0","0"
"511","경남","4877000","경남산청군","2013 산청세계전통의약엑스포","27600000000","0","0","0","0","28730570000","0","0","0","0","-1130570000","0","0","0","0"
"512","경남","4877000","경남산청군","산청한방약초축제","794629000","916000000","0","0","0","0","77000000","0","0","0","794629000","839000000","0","0","0"
"513","경남","4878000","경남함양군","함양산삼축제","412999450","507000000","0","0","0","0","77000000","0","0","0","412999450","430000000","0","0","0"
"514","경남","4879000","경남거창군","2012군민의날기념행사","0","571699000","0","0","0","0","0","0","0","0","0","571699000","0","0","0"
"515","경남","4879000","경남거창군","거창국제연극제","665338000","761553000","0","0","0","0","320000000","0","0","0","665338000","441553000","0","0","0"
"516","경남","4879000","경남거창군","거창한마당 대축제","574646000","0","0","0","0","0","0","0","0","0","574646000","0","0","0","0"
"517","경남","4880000","경남합천군","대야문화제","462000000","420000000","0","0","0","0","5000000","0","0","0","462000000","415000000","0","0","0"
"518","제주","4900000","제주본청","2012 제주국제관악제","0","534920000","0","0","0","0","0","0","0","0","0","534920000","0","0","0"
"519","제주","4900000","제주본청","2012 탐라대전","0","2419649000","0","0","0","0","0","0","0","0","0","2419649000","0","0","0"
"520","제주","4900000","제주본청","서귀포세계감귤박람회","910069856","0","0","0","0","0","0","0","0","0","910069856","0","0","0","0"
"521","제주","4900000","제주본청","세계 명품 생태관광 축제(WCC 부대행사)","0","1991336000","0","0","0","0","995668000","0","0","0","0","995668000","0","0","0"
"522","제주","4900000","제주본청","세계 유기농 한식 축제(WCC 부대행사)","0","600000000","0","0","0","0","300000000","0","0","0","0","300000000","0","0","0"
"523","제주","4900000","제주본청","제주 들불축제","806111600","756793000","0","0","0","0","0","0","0","0","806111600","756793000","0","0","0"
